10 10 
10 10 10 10 10 3 10 10 10 10
10 1 1 10 10 3 10 10 3 10
10 3 10 10 10 10 1 10 10 1
10 10 10 10 1 10 10 3 10 10
10 10 3 1 10 10 10 10 10 10
10 10 10 1 3 10 1 10 1 10
3 10 10 10 10 10 10 3 10 10
3 10 10 10 10 1 10 3 10 10
10 1 10 3 3 10 10 10 10 10
10 10 10 10 10 10 10 10 1 10

