10 10
1 1 2 3 4 1 2 5 2 1
1 1 2 3 4 1 2 5 2 1
1 1 2 3 4 1 2 5 2 1
1 1 2 3 4 1 2 5 2 1
1 1 2 3 6 6 2 5 2 1
1 1 2 3 6 6 2 5 2 1
1 1 2 3 4 1 2 5 2 1
1 1 2 3 4 1 2 5 2 1
1 1 2 3 4 1 2 5 2 1
1 1 2 3 4 1 2 5 2 1 
