20 20 
10 10 10 10 10 10 10 10 10 10 10 10 10 10 10 10 10 10 10 10 
10 10 10 10 10 13 13 13 10 10 10 10 10 10 10 10 10 10 10 10 
10 10 10 10 13 10 10 10 13 10 10 10 10 10 13 10 10 10 10 10 
10 10 10 10 13 10 10 10 10 10 10 10 10 10 13 10 10 10 10 10 
10 10 10 10 10 10 10 10 10 13 10 10 13 13 10 13 10 10 10 10 
10 10 10 13 10 10 10 10 10 13 13 10 10 10 10 10 10 10 10 10 
10 10 10 10 10 10 10 13 13 10 10 10 10 13 10 13 10 10 10 10 
10 10 10 13 10 10 10 10 10 10 13 10 10 10 10 10 10 10 10 10 
10 10 10 13 13 10 10 13 10 10 13 10 10 10 13 10 10 10 10 10 
10 10 10 10 13 13 10 13 10 10 10 10 10 10 10 10 10 10 10 10 
10 10 10 10 10 13 13 13 10 10 13 10 10 13 10 13 10 10 10 10 
10 10 10 10 10 10 10 10 10 10 13 10 10 10 10 13 10 10 10 10 
10 10 10 10 13 13 10 13 10 10 10 10 10 13 10 10 10 10 10 10 
10 10 10 13 13 13 13 13 13 13 13 10 13 10 10 13 10 10 10 10 
10 10 10 13 10 10 10 10 13 13 10 13 10 10 10 13 10 10 10 10 
10 10 10 13 13 13 10 10 13 10 13 10 10 10 13 10 10 10 10 10 
10 10 10 10 10 10 13 10 13 13 10 13 10 13 10 10 10 10 10 10 
10 10 10 10 10 10 10 10 13 13 10 10 10 10 10 10 10 10 10 10 
10 10 10 10 10 10 10 10 10 10 13 10 10 10 13 13 10 10 10 10 
10 10 10 10 10 10 10 10 10 10 10 13 13 13 10 10 10 10 10 10 

