20 20 
10 10 10 10 10 9 10 9 9 10 10 10 10 10 10 10 10 10 10 10 
10 10 10 10 10 9 9 10 10 10 10 10 10 10 10 10 10 -6 10 10 
10 10 10 10 10 10 10 9 10 9 10 10 10 10 10 10 10 -6 10 10 
10 10 10 10 10 10 9 9 9 9 9 9 9 9 10 10 10 -6 10 10 
10 10 10 10 10 9 10 10 10 10 9 10 10 10 10 10 10 -6 10 10 
10 10 10 10 10 9 10 10 10 10 9 10 9 10 9 10 10 -6 10 10 
10 10 10 10 10 9 9 10 10 9 9 10 10 10 10 10 13 -6 10 10 
10 10 9 9 10 10 10 9 9 9 10 10 9 10 10 9 10 -6 10 10 
10 9 10 10 10 10 13 13 13 13 13 13 10 10 10 9 10 -6 10 10 
10 9 10 10 10 13 10 10 10 10 10 10 13 13 10 10 10 -6 10 10 
9 10 10 10 13 10 10 10 10 10 10 10 10 10 9 9 10 -6 10 10 
10 9 10 13 10 10 10 10 10 10 10 10 9 9 13 10 10 -6 10 10 
10 10 9 13 9 9 10 9 9 10 9 10 9 10 10 13 -6 10 10 10 
10 10 10 13 10 10 10 10 10 10 10 10 10 10 10 10 -6 10 10 10 
10 10 10 10 13 13 10 10 10 10 10 10 10 10 10 13 -6 10 10 10 
10 10 10 10 10 -6 -6 10 10 10 10 10 10 10 10 -6 13 10 10 10 
10 10 10 10 10 13 -6 -6 -6 -6 13 13 10 -6 -6 13 10 13 10 10 
10 10 10 10 10 10 10 10 10 -6 -6 -6 -6 -6 10 10 13 13 10 10 
10 10 10 10 10 10 10 10 10 10 10 10 10 13 13 13 10 10 10 10 
10 10 10 10 10 10 10 10 10 10 10 10 10 10 10 10 10 10 10 10 

