10 10 
1 1 1 1 1 1 1 1 1 1 
1 1 1 1 1 1 1 1 1 1 
1 1 1 1 1 1 1 1 1 1 
1 1 1 1 1 1 1 1 1 1 
1 1 1 1 1 1 1 1 1 1 
1 1 1 1 1 1 1 1 1 1 
1 1 1 1 1 1 1 1 1 1 
1 1 1 1 1 1 1 1 1 1 
1 1 1 1 1 1 1 1 1 1 
1 1 1 1 1 1 1 1 1 1 
10 10 
-9 -9 1 1 -9 -9 -9 -9 -9 -9 
-9 -9 -9 -9 -9 -9 -9 -9 -9 -9 
-9 -9 -9 -9 -9 -9 -9 -9 -9 -9 
1 -9 -9 -9 -9 -9 -9 -9 -9 -9 
1 -9 -9 -9 -9 -9 -9 1 -9 -9 
1 1 -9 -9 -9 -9 -9 1 -9 -9 
-9 -9 -9 -9 -9 -9 -9 -9 -9 -9 
-9 -9 -9 -9 -9 -9 -9 -9 -9 -9 
1 -9 -9 -9 -9 -9 -9 -9 -9 -9 
-9 -9 -9 -9 -9 -9 -9 1 -9 -9 

